######
#    #
# `^X#
#    #
# @  ####
#       #
#  ##   #
#########
  