#################
#               #
# @          `  #
#               #
#################