#####
#   ###
# #X  #
# #X  #
#     #
#  @  #
#^ ` ^#
#######