     #####
     #   #
     # ^ #
     #   #
######   #######
#              #
# @          ` #
#              #
######   #######
     #   #
	 # X #
	 #   #
	 #####