#         #
#         #
# a #^# o #
#   #`#   #
##### #####