#######
#`    #
#     #
#    X#
# @ # #
#   #^#
#######
